7
7
3 3 3 3 3 3 3
3 3 0 0 4 0 3
3 0 5 0 3 0 3
3 0 4 2 0 0 3
3 0 0 3 2 3 3
3 3 0 1 0 3 3
3 3 3 3 3 3 3